####################
#    #             #
#                  #
#                  #
#                  #
#          X       #
#    O             #
#                  #
#                  #
#  O               #
#                X #
#                  #
#    X             #
#                  #
#                  #
#                  #
####################

