####################
#  O  #      O     #
#                  #
#                  #
#                  #
#          X       #
#    O             #
#                  #
#                  #
#  O               #
#         P      X #
#                  #
#    X             #
#                  #
#            O     #
#                  #
####################

