####################
#  O  #      O     #
#                  #
#                  #
#                  #
#          X       #
#    .             #
#                  #
#                  #
#  .               #
#         P      X #
#                  #
#    X             #
#                  #
#            O     #
#                  #
####################

